丈	zhàng	measure word for length; husband
与	yǔ	and; with; to give
严	yán	strict; severe
中	zhōng	middle; center
临	lín	to face; to approach
之	zhī	of; it (classical)
乎	hū	in; at; from (classical)
亚	yà	Asia; second
企	qǐ	to plan; enterprise
会	huì	can; to meet; meeting
伞	sǎn	umbrella
伴	bàn	companion; to accompany
似	sì	to resemble; similar
余	yú	surplus; extra
依	yī	to rely on; according to
促	cù	to urge; to promote
俗	sú	custom; vulgar
俩	liǎ	two; both
倍	bèi	times; -fold
兄	xiōng	elder brother
免	miǎn	to avoid; to exempt
兴	xīng	flourishing; to rise
兵	bīng	soldier; weapon
冰	bīng	ice; to freeze
减	jiǎn	to reduce; to subtract
几	jǐ	how many; several
分	fēn	to divide; minute; point
切	qiē	to cut; slice
列	liè	row; to list
则	zé	rule; then
刷	shuā	to brush; to swipe
刺	cì	thorn; to stab
劲	jìn	strength; energy
勇	yǒng	brave; courageous
即	jí	namely; immediately
却	què	but; yet; to decline
卷	juàn	volume; scroll; to roll
厘	lí	millimeter; tiny
厚	hòu	thick; deep
县	xiàn	county
叔	shū	uncle (father's younger brother)
召	zhào	to summon; to convene
史	shǐ	history; chronicles
叶	yè	leaf; page
吧	bā	particle indicating suggestion
含	hán	to contain; to hold
吸	xī	to inhale; to absorb
呀	yā	particle expressing surprise
呼	hū	to shout; to exhale
咸	xián	salty; all
哪	nǎ	which; where
售	shòu	to sell
啊	ā	ah; particle expressing surprise
固	gù	solid; firm
圆	yuán	circle; round
圾	jī	garbage; rubbish
址	zhǐ	site; location
均	jūn	equal; even; all
垃	lā	garbage; trash
型	xíng	model; type
培	péi	to cultivate; to train
堵	dǔ	to block; to stop up
塑	sù	to model; plastic
填	tián	to fill in; to stuff
士	shì	scholar; soldier
奋	fèn	to exert; to strive
奖	jiǎng	prize; award
妇	fù	woman; married woman
妻	qī	wife
姨	yí	aunt (mother's sister)
婆	pó	grandmother; old woman
孙	sūn	grandson; descendant
季	jì	season; period
守	shǒu	to guard; to defend
官	guān	official; government
宝	bǎo	treasure; precious
宽	kuān	wide; broad
寄	jì	to send; to mail
密	mì	dense; secret
寒	hán	cold; poor
寸	cùn	inch; very small
寻	xún	to seek; to search
尚	shàng	still; yet; to esteem
尺	chǐ	ruler; foot (measure)
尽	jìn	to exhaust; to use up
尾	wěi	tail; end
局	jú	bureau; office; situation
居	jū	to reside; to dwell
巨	jù	huge; gigantic
巴	bā	to expect; to cling to
巾	jīn	towel; napkin
帅	shuài	handsome; commander
席	xí	seat; banquet
帽	mào	hat; cap
幼	yòu	young; immature
序	xù	sequence; order; preface
府	fǔ	mansion; government office
延	yán	to prolong; to extend
引	yǐn	to lead; to pull
弯	wān	bent; curved
弱	ruò	weak; feeble
归	guī	to return; to belong to
彻	chè	thorough; penetrating
征	zhēng	to levy; to recruit
律	lǜ	law; rule; discipline
得	dé	to get; to obtain
微	wēi	tiny; micro
怀	huái	bosom; to cherish
惊	jīng	to startle; to surprise
战	zhàn	war; to fight
戴	dài	to wear; to put on
户	hù	household; door
打	dǎ	to hit; to strike
扩	kuò	to expand; to enlarge
扫	sǎo	to sweep; to clean
扬	yáng	to raise; to spread
承	chéng	to bear; to undertake
抄	chāo	to copy; to plagiarize
投	tóu	to throw; to invest
抱	bào	to hold; to embrace
抽	chōu	to draw out; to smoke
担	dān	to carry; to bear
招	zhāo	to recruit; to attract
择	zé	to select; to choose
括	kuò	to include; to embrace
挑	tiāo	to carry; to choose
挥	huī	to wave; to wield
授	shòu	to teach; to instruct
措	cuò	to arrange; measures
描	miáo	to depict; to describe
摆	bǎi	to arrange; to display
摇	yáo	to shake; to wave
摸	mō	to touch; to feel
操	cāo	to operate; to drill
擦	cā	to wipe; to rub
政	zhèng	politics; government
敌	dí	enemy; to oppose
斗	dòu	to fight; to struggle
料	liào	material; to anticipate
施	shī	to carry out; to bestow
无	wú	without; none
既	jì	already; since
映	yìng	to reflect; to shine
晒	shài	to dry in the sun
智	zhì	wisdom; intelligence
暑	shǔ	heat; hot weather
暗	àn	dark; dim; secret
替	tì	to replace; substitute
未	wèi	not yet; did not
权	quán	power; right
松	sōng	pine tree; loose
构	gòu	to construct; structure
林	lín	forest; woods
案	àn	case; table; record
梦	mèng	dream
梯	tī	ladder; stairs
森	sēn	forest; dense
棵	kē	measure word for trees
植	zhí	to plant; to grow
殊	shū	special; unique
毕	bì	to finish; to complete
毫	háo	fine hair; milli-
汇	huì	to converge; to collect
江	jiāng	river
沉	chén	to sink; heavy
治	zhì	to govern; to cure
泉	quán	spring (water); fountain
泪	lèi	tears
浅	qiǎn	shallow; simple
测	cè	to measure; to test
浓	nóng	thick; dense; strong
淡	dàn	light (color); bland; indifferent
渐	jiàn	gradually
湿	shī	wet; damp; moist
源	yuán	source; origin
潮	cháo	tide; damp; fashionable
激	jī	to excite; to arouse
炼	liàn	to refine; to smelt
烧	shāo	to burn; to cook
燃	rán	to burn; to ignite
牙	yá	tooth; ivory
独	dú	alone; single
率	lǜ	rate; frequency
玉	yù	jade; precious stone
瓜	guā	melon; gourd
甚	shèn	very; extremely
申	shēn	to state; to express
疑	yí	to doubt; to suspect
疗	liáo	to treat; therapy
登	dēng	to climb; to mount
的	de	of; possessive particle
益	yì	benefit; profit; advantage
盐	yán	salt
盖	gài	lid; cover; to build
盘	pán	plate; to coil
矮	ǎi	short; low
矿	kuàng	ore; mine
码	mǎ	code; number
研	yán	to grind; to research
秀	xiù	elegant; beautiful; to show
种	zhǒng	kind; type; to plant
秘	mì	secret; mysterious
移	yí	to move; to shift
稳	wěn	stable; steady
究	jiū	to investigate; to study
穷	qióng	poor; exhausted
窗	chuāng	window
竟	jìng	unexpectedly; actually
童	tóng	child; childish
符	fú	mark; symbol; to conform
笨	bèn	stupid; clumsy
粗	cū	coarse; rough
粮	liáng	grain; food
系	xì	system; to tie
累	lèi	tired; to accumulate
纯	chún	pure; simple
纷	fēn	confused; in disorder
细	xì	thin; fine; detailed
络	luò	net; to connect
统	tǒng	to unite; system
维	wéi	to maintain; dimension
综	zōng	comprehensive; to sum up
缓	huǎn	slow; gradual
编	biān	to weave; to compile
缩	suō	to shrink; to reduce
置	zhì	to place; to put
翻	fān	to turn over; to translate
耳	ěr	ear
聊	liáo	to chat; to have a talk
聚	jù	to gather; to assemble
肚	dù	belly; stomach
肥	féi	fat; fertile
胸	xiōng	chest; breast
脱	tuō	to take off; to shed
腐	fǔ	rotten; decayed; corrupt
腰	yāo	waist; middle
致	zhì	to send; to cause
航	háng	boat; ship; to navigate
良	liáng	good; fine
获	huò	to obtain; to capture
著	zhù	to write; to attach; book
虑	lǜ	to consider; anxiety
虫	chóng	insect; worm
袋	dài	bag; sack
袜	wà	sock; stocking
裹	guǒ	to wrap; to bind
角	jiǎo	angle; corner; horn
译	yì	to translate; to interpret
诗	shī	poetry; poem
诚	chéng	sincere; honest
谓	wèi	to call; to say
豆	dòu	bean; pea
贝	bèi	shell; precious
财	cái	wealth; money
败	bài	to defeat; to lose
货	huò	goods; commodity
质	zhì	quality; substance
购	gòu	to buy; to purchase
贴	tiē	to stick; to paste
赏	shǎng	to reward; to appreciate
赞	zàn	to praise; to support
趋	qū	to tend toward; to hasten
趣	qù	interest; interesting
距	jù	distance; to be apart
躺	tǎng	to lie down
轮	lún	wheel; to take turns
辣	là	spicy; hot
辩	biàn	to debate; to argue
迅	xùn	rapid; swift
迟	chí	late; slow; to delay
迫	pò	to force; to compel
述	shù	to state; to narrate
透	tòu	to penetrate; thorough
逐	zhú	to chase; gradually
递	dì	to hand over; to pass
途	tú	way; route
逛	guàng	to stroll; to roam
遇	yù	to meet; to encounter
避	bì	to avoid; to shun
郎	láng	young man; gentleman
酸	suān	sour; acid
醒	xǐng	to wake up; to sober up
释	shì	to explain; to release
量	liàng	quantity; amount; to measure
针	zhēn	needle; to inject
销	xiāo	to sell; to market
锻	duàn	to forge; to temper
镜	jìng	mirror; lens
闪	shǎn	to flash; to dodge
闭	bì	to close; to shut
闹	nào	noisy; to make noise
阅	yuè	to read; to review
阵	zhèn	period; spell; burst
阶	jiē	step; rank
阻	zǔ	to block; to hinder
阿	ā	prefix for names; to flatter
附	fù	to attach; to enclose
陆	lù	land; continent
限	xiàn	limit; to restrict
隔	gé	to separate; to isolate
雷	léi	thunder; mine
顶	dǐng	top; peak; to carry on the head
项	xiàng	item; term; clause
骨	gǔ	bone
鲜	xiān	fresh; bright
默	mò	silent; quiet; to write from memory
